HAI = "countries/Haiti.txt"
USA = "countries/Trump.txt"
FRA = "countries/Biden.txt"
PRA = "countries/Sanders.txt"
GLA = "countries/Great Lakes.txt"
TEX = "countries/Texas.txt"
CSA = "countries/Confederacy.txt"
FLO = "countries/Florida.txt"
VIR = "countries/Virginia.txt"
AFS = "countries/Free State.txt"
MOL = "countries/Molossia.txt"
NAV = "countries/Navajo.txt"
HOP = "countries/Hopi.txt"
JEB = "countries/Jeb Revolt.txt"
TOH = "countries/Tohono.txt"
PAC = "countries/Pacific Fleet.txt"
CAS = "countries/Cascadia.txt"
NRA = "countries/West Virginia.txt"
CAN = "countries/Canada.txt"
MEX = "countries/Mexico.txt"
BAH = "countries/Bahamas.txt"
CUB = "countries/Cuba.txt"
BLZ = "countries/Belize.txt"
COL = "countries/Colombia.txt"
COS = "countries/Costa Rica.txt"
DOM = "countries/Dominican Republic.txt"
ELS = "countries/El Salvador.txt"
GUA = "countries/Guatemla.txt"
HON = "countries/Honduras.txt"
JAM = "countries/Jamaica.txt"
NIC = "countries/Nicaragua.txt"
PAN = "countries/Panama.txt"
PUE = "countries/Puerto Rico.txt"
VEN = "countries/Venezula.txt"
VIS = "countries/Virgin Islands.txt"
NEW = "countries/New England.txt"
SIN = "countries/Sinola Cartel.txt"
UTA = "countries/Utah.txt"
LAS = "countries/Las Vegas.txt"
ENG = "countries/Britain.txt"
FFR = "countries/France.txt"
BER = "countries/Bermuda.txt"
HOL = "countries/Holland.txt"
BEF = "countries/British Expeditionary Forces.txt"
TAT = "countries/Trinidad and Tobago.txt"
OKL = "countries/Oklahoma.txt"
LOU = "countries/Louisiana.txt"
MON = "countries/Montana.txt"
KFC = "countries/Kentucky.txt"
IDA = "countries/Idaho.txt"
BOS = "countries/Boston.txt"
ARC = "countries/American Red Cross.txt"
NPA = "countries/National Protection Alliance.txt"
ISA = "countries/Islamic State.txt"
RMV = "countries/Romanov Empire.txt"
LGB = "countries/LGBT Country.txt"
ZIO = "countries/Zion.txt"
KKK = "countries/Klan.txt"
CSB = "countries/Second Confederacy.txt"
AFR = "countries/Afrika.txt"
DAK = "countries/Dakota.txt"
MNS = "countries/Minnesota.txt"
KAN = "countries/Kansas.txt"
IOW = "countries/Iowa.txt"
NBR = "countries/Nebraska.txt"
ALA = "countries/Alaska.txt"
SAZ = "countries/Seattle.txt"
DET = "countries/Detroit.txt"
KMT = "countries/Turkey.txt"
GTB = "countries/Guantanamo_Bay.txt"
TIM = "countries/Pool Compound.txt"
AFO = "countries/Area 51.txt"
LIB = "countries/Liberty.txt"
APA = "countries/apalachia.txt"
#Canadian Tags
OOR = "countries/Orange.txt"
QUE = "countries/Quebec.txt"
NFL = "countries/Newfoundland.txt"
MLC = "countries/Monarchist League Canada.txt"
NUN = "countries/Nunavut.txt"
ALT = "countries/Alberta Trumpists.txt"
ARY = "countries/Aryan Guard.txt"
ANT = "countries/Alberta Independent.txt"
VAN = "countries/Vancouver.txt"
BRC = "countries/British Colombia.txt"
TEM = "countries/Canadian Templars.txt"
#Californian Tags
PRC = "countries/ComChina.txt"
JFR = "countries/Jefferson.txt"
HLY = "countries/Hollywood.txt"
CST = "countries/Scientology.txt"
ACF = "countries/AltaCalifornia.txt"
SAC = "countries/Sacremento.txt"
ABG = "countries/Border_Patrol.txt"
NVD = "countries/Nevada.txt"
SIL = "countries/Silver Legion.txt"
#Anarchist Collapse
THO = "countries/Tahoe.txt"
SBB = "countries/Santa Barbara.txt"
FSN = "countries/Fresno.txt"
BKR = "countries/Bakersfield.txt"
MOJ = "countries/Mojave.txt"
MNT = "countries/Monterey.txt"
RWD = "countries/Redwood.txt"
#Mexican Tags
BJC = "countries/Baja California.txt"
ZAP = "countries/Zapatistas.txt"
RMX = "countries/Mexico 2.txt"
WMX = "countries/West Mexico.txt"
CAR = "countries/Cartels.txt"
YUC = "countries/Yucatan.txt"
ADF = "countries/Auto Defence Forces.txt"
#Texas collapse tags
FTA = "countries/Free Texan Army.txt"
FAL = "countries/Falangists.txt"
BET = "countries/Beto Clique.txt"
CRN = "countries/Crenshaw Clique.txt"
BLA = "countries/Black Army Texas.txt"
BSH = "countries/Bush Clique.txt"
CRU = "countries/Cruz Clique.txt"
RED = "countries/Red Army Texas.txt"
SAN = "countries/San Antonio.txt"
NMX = "countries/New Mexico.txt"

LYM = "countries/Lyman Bishop.txt"
BKF = "countries/Blackfeet.txt"

#Virginia Collapse Tags
MGV = "countries/Margaritaville.txt"
RVR = "countries/Republican_Virginia.txt"

###MERCENARY TAGS- NOT TO BE USED IN STATES
WAG = "countries/Wagner Company.txt"